##########
####### ##
####  # ##
###HK # ##
### K * ##
#### K   #
###*K   ##
###*     #
####*#####
##########