##########
#     *  #
#K   HK  #
#*# ##   #
### *K ###
#        #
#        #
#     K  #
#    K **#
##########