##########
##########
## # K*H##
##      ##
######  ##
####    ##
## *K ####
#### #####
##########
##########