##########
#H   #*  #
# KK #  *#
#  KK#   #
#  # #   #
#### #*  #
#     # ##
#        #
#   *    #
##########