##########
#H    *  #
# KK #  *#
#  KK#   #
#  # #   #
#### #*  #
#     # ##
#        #
#   *    #
##########