##########
###   ####
### K  ###
##   K ###
## #   ###
## #K#####
## #H**###
## K   *##
## #    *#
##########