##########
###  #####
### K  ###
##   K ###
## #   ###
## #K#####
## #  *###
## K  **##
## #    *#
##########