##########
###  #####
### K  ###
##   K ###
## #   ###
## #K#####
## # **###
## K   *##
## #    *#
##########